Bad Girl Good Girl - 미쓰에이
STEP - 카라
Roly-Poly - 티아라
비가 오는 날엔 - 비스트
So Cool - 씨스타
아메리카노 - 10cm
Beautiful - 비스트
비도 오고 그래서(Feat. 신용재) - 헤이즈
밤편지 - 아이유
오랜 날 오랜 밤 - 악동뮤지션
우주를 줄게 - 볼빨간사춘기
사계 - 태연
모든 날, 모든 순간 - 폴킴
Lovesick Girls - BLACKPINK
취기를 빌려 - 산들
오래된 노래 - 스탠딩 에그
내 마음이 움찔했던 순간 - 규현
광화문에서 - 규현
눈누난나 (NUNU NANA) - 제시
아로하 - 조정석
View - 샤이니
bad guy - Billie Eilish
Paris In The Rain - Lauv
2002 - Anne Marie
Shape of You - Ed Sheeran
YOUTH - Troye Sivan
Santa Tell Me - Ariana Grande
Like Strangers Do - AJ Mitchell
Sugar - Maroon 5
Jason Mraz - I'm Yours
Lenka - The Show
Lenka - Everything At Once
Bruno Mars - marry  you
Adele - Rolling in the deep
ABBA - Dancing Queen
West Life - My Love, You raise me up
Beatles - I Will
Maroon5 - Payphone
Love Me Tender - Elvis Presley
If - Bread
Don't Forget To Remember - Bee Gees
Rain & Tears - Aprodite's Child
Somebody To Love - Queen
Eagles - Hotel California 